111111111111111111
100000000000000001
100000000000000C01
10000000000C00H0C1
100000000000000001
100000000000000001
10000000000000H001
100000000000000HH1
10P0000000000000E1
111111111111111111