NO	./sprites/betteriron.xpm
SO                              ./sprites/name.xpm
WE ./sprites/nicewhitewall.xpm

F 100,100,100
C 200,200,200

EA ./sprites/roughness.xpm
        11111111111111111111111111111
        11001110000000000000000000001
1111111100000000000001100111000111111
100000000000000000000001111111111001
1000000000000000000000001111111111001
1000000000000000000000000000000000001
10000000000000000000000000000000000001
1000S00000000000000000001111111111110
111111111111111111111111
