NO ./sprites/grass.xpm
SO ./sprites/grass.xpm
EA ./sprites/tree1694020873.xpm
WE ./sprites/tree1694020873.xpm

F 85,107,47
C 153,201,255


                11111111111111111111111111
                10000000001100000000000011
                10110000011100000000000011
111111111111111111001000000000000000001011
111111111011000001110000000000001111111111
101000000011000001110111110111111111111111
11110111111111011100000010001
11110111111111011101010010001
11000000110101011100000010001
10001000000000001100000010001
10000000000000001101010010001
11000001110101011111011110N0111
1111011111101011011110100011111
111111111111111111111111111