NO        ./sprites/North_Wall.xpm


SO ./sprites/South_Wall.xpm




                                                        WE                      ./sprites/West_Wall.xpm
EA ./sprites/East_Wall.xpm





C      135,206,235                             
F 128,128,128





1111111111111111111111111111111111
        110000000001100000000000111111111
        1011000001110000000000011
        10010000000000000N0000001
111111111011000001110000000000001
100000000011000001110111111111111
111101111111110111000000100011
111101111111110111010100100011
1101000001100101011100000010001
1000000000000000110000001000111
10000000000     00000110101001000111
1100000111010101111101111001111111
11110111111010110111110100011111
11111111111111111111111111111
 0  
  0  
   0 
11110
1111