NO sprites/purplestone.xpm
SO sprites/colorstone.xpm
WE sprites/redbrick.xpm
EA sprites/barrel.xpm

F 128,128,128
C 135,206,235

111111111111              
100001100001          
100001100001
100001100001
100000000001
100001100001
100001100001
100001100001
100N01100001
100000000001
111111111111