1111111111111111
1E0H000000000001
1010010100100001
1P0000000C00C0C1
1111111111111111