11111111111111
1H0000000000H1
100C0000000001
100000H0C00001
10P000000000E1
11111111111111