11111111111111111111
10000000000000000001
10C00C000C000C00C001
10000000000000000001
100C00C000C000C00C01
10000000000000000001
10C00C000C000C00C001
10000000000000000001
100C00C000C000C00C01
10000000000000000001
10C00C000C000C00C001
100000000000000000E1
1P000000000110000001
11111111111111111111