1111111111111111111111111111111111111111
1000000000000000000000000000000000000001
10C00C000C000C00C00000000000000000000001
1000000000000000000000000000000000000001
100C00C000C000C00C0000000000000000000001
1000000000000000000000000000000000000001
10C00C000C000C00C00000000000000000000001
1000000000000000000000000000000000000001
100C00C000C000C00C0000000000000000000001
1000000000000000000000000000000000000001
10C00C000C000C00C00000000000000000000001
10C00C000C000C00C00000000000000000000001
10C00C000C000C00C00000000000000000000001
10C00C000C000C00C00000000000000000000001
10C00C000C000C00C00000000000000000000001
10C00C000C000C00C00000000000000000000001
10C00C000C000C00C00000000000000000000001
10C00C000C000C00C00000000000000000000001
100000000000000000E000000000000000000001
1P00000000011000000000000000000000000001
1111111111111111111111111111111111111111