1111111111111111111111111111111111111111
1H00000000000000H0000000H00000000000H001
10C00C000C000C00C00000000000000000000001
100000000000000000000000000000000000H001
100C00C00HC000C00C0000H0000000H000000001
1000000000000000000000000000000000000001
10C00C000C000C00C000000000000000H0000001
10H00000H0000000000000000000000000000001
100C00C000C000C00C0000000000000000000001
1000000000H00000000000H00000000000000001
10C00C000C000C00C0000000000000000H000001
10C00C000C000C00C00000000000000000000001
10CH0C0H0C000C00C000H0000000000000000001
10C00C000C000C00C0000000000H000000000001
10C00C000C000C00C00000000000000000000001
10C00C0H0C000C00C0000000H000000000000001
10C00C000C000C00C000000000000000H0000001
10C00C0H0C000C00C00000000000000H00000001
100000000000000000E0000H0000000000000001
1P0000H0000110000000H0000000000000000H01
1111111111111111111111111111111111111111